/-----------T-----------T-----------\
|E..........|...........|..........E|
|./--\./--\.|./--\./--\.|./--\./--\.|
|.|  |.|  |.|.|  |.|  |.|.|  |.|  |.|
|.L--l.L--l.|.L--l.L--l.|.L--l.L--l.|
|...................................|
|./--\.|../---\..|.|../---\..|./--\.|
|.L--l.|..L---l..|.|..L---l..|.L--l.|
|......|.........|.|.........|......|
|......}--.....--{C}--.....--{......|
|../\..|.........|.|.........|../\..|
|..Ll..|..-----..|.|..-----..|..Ll..|
|......|.........|.|.........|......|
|...................................|
|./--\..../---\..|.|../---\..../--\.|
|EL--l....L---l..|.|..L---l....L--l.|
|...................................|
L-----------------------------------l