######################################
#                                    #
# ##     # ############## ########## #
# ## C   #             ## #####   E  #
# ## ##### ##       ## ##          # #
#    ##     # ########    ##### #### #
# ########          ##### #  ## ###  #
#           ##### # #     #  ## ### ##
# ##   ########## # ##### #  ## ### ##
# #### #                            ##
#  E   # ################### ###### ##
# ##   # ####                #      ##
# ##   #      ##################### ##
# ##     ####                        #
# ## ##  ####  # ####  ####### ####  #
# ## ### ####### #     ####### #     #
# ## ##        # ####  #     # ####  #
#                                   E#
######################################